.......2.2.2........
....................
....XXXX........XX..
....X...........X...
....X...............
....XX.........XXX..
....................
........XXXX........
........X...........
........X.......XX..
....................
..XXX........XXXX...
................X...
...X............X...
...XXXXX............
.................XX.
....................
....................
....................
.......1.1.1........
