00000002020200000000
00000000000000000000
0000xxxx00000000x000
0000x00000000000x000
0000x000000000000000
000xx000000000xxx000
00000000000000000000
00000000xxxx00000000
00000000x00000000000
00000000x0000000x000
00000000000000000000
0000000000000xxxx000
0000000000000000x000
00000000000000000000
000xxxxx000000000000
00000000000000000xx0
00000000000000000000
00000000000000000000
00000000000000000000
00000001010100000000
